20
20
....................
....................
....................
....................
....................
....................
....................
....................
....................
....................
X.......XX...X...XXX
X.X...XXXXX.X..XX..X
X.X....L.......XX..X
X.X.XXXXX..........X
X.X.XXXX....L...X.XX
XXXXXXXX....LL.....X
X..X...............X
X..X.XX..X..XX.XXX.X
X....XX..XXXX....XXX
XXXXXXXXXXXXXXXXXXXX
